1,7,4,0,9,4,8,8,2,4,
5,5,1,7,1,1,5,2,7,6,
1,4,2,3,2,2,1,6,8,5,
7,6,1,8,9,2,7,9,5,4,
3,1,2,3,3,4,1,1,3,8,
7,4,2,7,7,9,3,1,9,8,
6,5,0,2,8,6,0,2,4,8,
6,5,0,9,0,0,6,1,3,8,
9,3,4,4,6,0,6,6,1,8,
4,9,6,3,7,8,8,2,9,1,
